0000000000000000000000000000000000000000000000000000000000000000
0000000000000000000000000000000000000000000000000000000000000000
0000000222222222223233223322222223222222232222222222222222000000
0000000222222222222333333323333333333322232333332223332222000000
0000000233333323022333333333333333333323233233333233333322000000
0000000233333333333333333333333333333333333333333333333322000000
0000000223333332333333330333333333333333333333333333333332200000
0000000223333333333332223323333333333333333332333333333332200000
0000000023333333333332222333300330323233323333033303033333200000
0000000022333333333322233333333333333333322333332223333322200000
0000000233333333333223333333333333322333323333332333333322000000
0000000333330333332223333333333333333333332333333333333332000000
0000000333322333322323333333333333333333332223333333333232000000
0000000230222333332233333333333333233322232333333333333322000000
0000000223333333333223333333333333223222233333330303333333200000
0000000223332333333333333333333332222222233333322223233332200000
0000000022333333333333333302333222222222333333222322233333200000
0000000022223333333333333322222222222223333222233323333332200000
0000000222333333303333333333222222222223332222333333333332000000
0000000233333223333333333332232332222223333322233333233333000000
0000000223332223333233333333332223232223333223333333233333000000
0000000223333223332222223333333333332333333323333332223333000000
0000000223333223333223322333333333333333333333322333223332300000
0000000223333333333222232333333333333333333333333333033333200000
0000000023333233333232233302233333333333333033333333333332200000
0000000023333333333233222222223333333333222333333333333322200000
0000000233320333333333222220333333333323333333333333333322000000
0000000223333333333333322223333333333222222333333333333332000000
0000000223333333333333322223333333333322222333333332233332000000
0000000233333333333333332222233333333322222333333332233332000000
0000000233333033333333322222233333333322223333333303333333100000
0000000223333333332333223233333333333322233333333233333221100000
0000000023332303322233033333333333333232223333332223332211100000
0000000022333323333333333333332222333332222333322223333221100000
0000000233332333333033333333322222333322222222222233332211000000
0000000223332223333333333332222222333322222222222223322221000000
0000000233333233333333333232222222333333322222233333331111000000
0000000233333223222333332322222222333333332222233333331111000000
0000000233333222232333330322223222232333333332233333323111100000
0000000233333333333333323322333332223333333333333333332231100000
0000000022333333333333223322333333223333333333333333332211200000
0000000022233333333333222333333333333333223333333223332211200000
0000000232233333333332223333333333333333302333332233323222000000
0000000223333332333322233333333333322333322233322223333332000000
0000000223333332233332233333333333332333232333322223333332000000
0000000233333322333332222333333333333333333333332033333222000000
0000000223333333233333322023030330333333323333333033333222200000
0000000222333333333333233322233333222332233333333333333322200000
0000000022333333333233333333323333222322333332233333333322200000
0000000023333333332233333333333333333333333322323333333322200000
0000000223333322332333333333333333333333332222223233333222000000
0000000222222222232222211323333333333133332222222222322222000000
0000000222222222233332211122133313333112222222222222222222000000
0000000000000000000000000000000000000000000000000000000000000000
0000000000000000000000000000000000000000000000000000000000000000
