0000000000000000000000000000000000000000000000000000000000000000
0000000000000000000000000000000000000000000000000000000000000000
0011111111111111113331111111111133111111111111111133111111111100
0001111111111110133333333111111333331311111133333333333331111100
0001111111111303333333333333313333333333333333333333333333111100
0001111111111333333333333333333333333333333333333323333333311100
0001111111111333332222333333333333333333333322222222233333111100
0011111111003333322222333333333033330033333322222222233330011000
0011111110223233332332222333332233333233333322223332033332220000
0011111102333333302333222333332233332233333333223332333003222000
0011111102333223332333322233332223333223333333333333333333322100
0001111100233333333333322233333223333223330222333333333333322100
0001113331233333333333322223333333332233333222233333333333323100
0001113333023333333333322223333333333333332233333333233333333300
0001110333333332222333223323333333333333333333333322223333333300
0011103333333322222333333333333333333333333333333222223333333000
0011133333333222223333333333333333323333333333333222233333333000
0011333223333322223333333333330033023333332233333333333333333000
0011133222333333333333223333223332223033332233333333333332333100
0001133223233333333333322333223332233333333333333333333332033100
0001333323333333333233323333323332233333333333333333222332233100
0001333223333320333223333333333333233333333322323333222332233300
0001133323332222333333333333332333333332233332223333322222333100
0011332232222223333333333033323333332223333333333333332233331000
0011333222222223333333333333333333222233333333333333333333331000
0011333322333333333333333223333332222223333333333333333333311000
0011033333333333333333333322333332233333333333333323333333331100
0001333333333332233333333322233333233333333333333333333233231100
0001022333233322233333333333333333333333333333333333333333333300
0001222333333322333323333333333333333330333333333303333333333300
0001333333333333333322333333333233332323333333333333333333333300
0013333333333333333233033333322233322233333330333333333332331000
0012223332233323332233223333332223322233323322333333333332111000
0011221333233323332233233333332233322333332222333333333332011000
0011111333333333333333332333333222222333323333233332222233311100
0001111033333330033333323033333333333333222333303302222223331100
0001111033333332333333333333333333333333332333333333333223331100
0001113333333222333333333333333333333333333233333333333222333100
0001132333332233333333333333333333333333333333333333333332333100
0011333333322233333322333333303333333333333333333333333322331000
0011103333222333333222333222233333333333333333322223333222333000
0011103332322333333222333232233333333333333333322223333222333000
0011113333223333333222233332223333233323333333333222333333331100
0001111333222232333322233333303333233323333303333322233333333100
0001111333332222233223333333333332223332333333333332333333333100
0001111133333333333332333333223333223332333322333333333333203300
0001111111333333333333332233223333323332333322333333333333222100
0011111113333333333333332222333333333303333222333033023333221000
0011111111133333233323333333333333333333333332222333320333320000
0011111111112333233322333333333333333333333333333333310222221000
0011111111113330223323333333333113333333333333333333331102111100
0001111111111110223323333333311111333333331333333332311111111100
0001111111111111100011311111111111111111111111111111111111111100
0000000000000000000000000000000000000000000000000000000000000000
0000000000000000000000000000000000000000000000000000000000000000
